1111111111111111111
1E1000000C000N00001
1010010100101C10101
1000010100100C00101
1010010100101010001
1C100100101010101P1
1111111111111111111