1111111111111111111111111111111111
1E0000000000000C00000C00N000000001
1010010100100C00101001000000010101
1010010100100C00101001000000010101
1010010100100C00101001000000010101
10100100101010100010010000P0010101
1111111111111111111111111111111111