1111111111111111111
1E1000001C100100001
1010010100101C10101
1010000000000000101
1010010000000000001
1010000000NNNN00N01
1010010000000100101
1010000000100000001
1N000100101010101P1
1111111111111111111