111111111111111111
10010000000C000001
10000000N000000001
1P0011000000000011
10010000000C000001
10000000N000000001
1P0011000000000011
10010000000C000001
100000000000000001
1P0011000000000011
10010000000C000001
1000000E0000000001
1P0011000000000011
111111111111111111