1111111111111111111
1E10000010100010101
1010010100001C10C11
1010100000100010001
10101C10C1C11010011
1011N100C0000N10011
1010000N010001100C1
101C111100111110001
1C000100NC0000001P1
1111111111111111111